x座標,y座標,幅,高さ,rad,radpUus,vx,vy
365,216,101,104,0,0,0,0
263,112,101,104,0,0,0,0
162,218,101,104,0,0,0,0
367,5,101,104,0,0,0,0
265,320,101,104,0,0,0,0
162,424,101,104,0,0,0,0
468,530,101,104,0,0,0,0
569,426,101,104,0,0,0,0
568,215,101,104,0,0,0,0
669,110,101,104,0,0,0,0
