Start.x,Start.y,Goal.x,"Goal,y"
40,229,530,228
Block,12,個
x座標,y座標,幅,高さ,rad,radpUus,vx,vy
849,257,59,95,0,0,0,0
280,669,92,446,0,0,0,0
372,201,202,0,0,0,0,0
903,116,71,157,0,0,0,0
477,624,127,113,0,0,0,0
119,660,110,101,0,0,0,0
59,410,122,130,0,0,0,0
329,30,122,130,0,0,0,0
364,386,122,130,0,0,0,0
55,75,101,101,0,0,0,0
612,459,101,101,0,0,0,0
621,43,101,101,0,0,0,0
Wire,2,個
始点.x,始点.y,終点.x,終点.y
587,34,470,198
450,319,590,445
