x座標,y座標,幅,高さ,rad,radpUus,vx,vy
234,73,56,113,0,0,0,0
524,236,56,38,0,0,0,0
297,418,56,38,0,0,0,0
327,203,56,38,0,0,0,0
228,315,56,38,0,0,0,0
445,344,56,38,0,0,0,0
448,449,56,38,0,0,0,0
241,515,56,38,0,0,0,0
113,431,56,38,0,0,0,0
108,541,56,38,0,0,0,0
435,148,56,38,0,0,0,0
534,66,56,38,0,0,0,0
