x座標,y座標,幅,高さ,rad,radpUus,vx,vy
517,502,50,184,0,0,0,2
517,210,50,184,0,0,0,2
399,400,50,184,0,0,0,2
399,120,50,184,0,0,0,2
269,318,50,184,0,0,0,2
269,68,50,184,0,0,0,2
269,352,50,184,0,0,0,2
146,466,50,184,0,0,0,2
146,170,50,184,0,0,0,2
146,512,50,184,0,0,0,2
