Start.x,Start.y,Goal.x,"Goal,y"
31,547,682,38
Block,10,個
x座標,y座標,幅,高さ,rad,radpUus,vx,vy
517,214,50,184,0,0,0,2
517,524,50,184,0,0,0,2
399,112,50,184,0,0,0,2
399,434,50,184,0,0,0,2
269,30,50,184,0,0,0,2
269,382,50,184,0,0,0,2
269,64,50,184,0,0,0,2
146,178,50,184,0,0,0,2
146,484,50,184,0,0,0,2
146,224,50,184,0,0,0,2
Wire,0,個
始点.x,始点.y,終点.x,終点.y
